###########################################################
#                                                         #
#                                                         #
#                                                         #
#          O                      O                       #
#                                             O           #
#                                                         #
#                                                         #
#                                                         #
#                          #                              #
#                                                         #
#                #                                        #
#          X                                              #
#                                      #       X          #
#                                                         #
#                   X                                     #
#                                  P                      #
#                                                         #
#                                                         #
###########################################################
